91 91 91 91 91 91 91 91 91 91 91 91 91 91 91 53 91 91 91 91 91 91 91 91 91 91
47 47 47 47 47 47 47 47 47 47 47 47 47 47 47 53 47 47 47 47 47 47 47 47 47 47
44 45 46 44 45 46 44 45 46 44 45 46 44 45 46 53 46 46 44 45 46 44 45 46 44 45
44 45 46 44 45 46 44 45 46 44 45 46 44 45 46 53 45 46 44 45 46 44 45 46 44 45
44 45 46 44 45 46 44 45 46 44 45 46 44 45 46 53 45 46 44 45 46 44 45 46 44 45
44 45 46 44 45 46 44 45 46 44 45 46 44 45 46 53 45 46 44 45 46 44 45 46 44 45
48 48 48 48 48 48 48 48 48 48 48 48 48 48 48 53 48 48 48 48 48 48 48 48 48 48
49 49 49 49 49 49 49 49 49 49 49 49 49 49 49 49 49 49 49 49 49 49 49 49 49 49
71 71 71 71 71 71 71 71 71 71 74 72 72 72 72 73 71 71 71 71 71 71 71 71 71 71
68 68 68 68 68 68 68 68 68 68 68 68 68 68 68 68 68 68 68 68 68 68 68 68 68 68
68 68 68 68 68 68 68 68 68 68 68 68 68 68 68 68 68 68 68 68 68 68 68 68 68 68
68 68 68 68 68 68 68 68 68 68 68 68 68 68 68 68 68 68 68 68 68 68 68 68 68 68
68 68 68 68 68 68 68 68 68 68 68 68 68 68 68 68 68 68 68 68 68 68 68 68 68 68
68 68 68 68 68 68 68 68 68 68 68 68 68 68 68 68 68 68 68 68 68 68 68 68 68 68
69 69 69 69 69 69 69 69 69 69 76 70 70 70 70 75 69 69 69 69 69 69 69 69 69 69
49 49 49 49 49 49 49 49 49 49 49 49 49 49 49 49 49 49 49 49 49 49 49 49 49 49
49 49 49 49 49 49 49 49 49 49 49 49 49 49 49 49 49 49 49 49 49 49 49 49 49 49
50 51 52 50 51 52 50 51 52 50 51 52 49 49 50 51 52 50 51 52 50 51 52 50 51 52