18 18 18 18 18 18 18 18 18 18 18 0 0 0 0 18 18 18 18 18 18 18 18 18 18 18
25 12 12 12 12 12 12 12 12 12 12 12 12 12 12 12 12 12 12 12 12 12 12 12 12 25
11 11 11 11 11 11 11 11 11 11 11 11 11 11 11 11 11 11 11 11 11 11 11 11 11 11
11 11 11 11 11 11 11 11 11 11 11 11 11 11 11 11 11 11 11 11 11 11 11 11 11 11
11 11 11 11 11 11 11 11 11 11 11 11 11 11 11 11 11 11 11 11 11 11 11 11 11 11
11 11 11 11 11 11 11 11 11 11 11 11 11 11 11 11 11 11 11 11 11 11 11 11 11 11
24 10 10 10 10 10 10 10 10 10 10 10 10 10 10 10 10 10 10 10 10 10 10 10 10 24
22 9 8 9 8 9 8 9 8 9 8 9 8 9 8 9 8 9 8 9 8 9 8 9 8 23
6 13 6 7 6 13 6 7 6 13 6 7 6 13 6 7 6 13 6 7 6 13 6 7 6 13
5 16 5 4 5 16 5 4 5 16 5 4 5 16 5 4 5 16 5 4 5 16 5 4 5 16
7 14 7 6 7 14 7 6 7 14 7 6 7 14 7 6 7 14 7 6 7 14 7 6 7 14
4 15 4 5 4 15 4 5 4 15 4 5 4 15 4 5 4 15 4 5 4 15 4 5 4 15
6 13 6 7 6 13 6 7 6 13 6 7 6 13 6 7 6 13 6 7 6 13 6 7 6 13
3 17 3 3 3 17 3 3 3 17 3 3 3 17 3 3 3 17 3 3 3 17 3 3 3 17
21 1 2 1 2 1 2 1 2 1 2 1 2 1 2 1 2 1 2 1 2 1 2 1 2 20
19 0 0 0 0 0 0 0 0 0 0 0 0 0 0 0 0 0 0 0 0 0 0 0 0 19
19 0 0 0 0 0 0 0 0 0 0 0 0 0 0 0 0 0 0 0 0 0 0 0 0 19
19 19 19 19 19 19 19 19 19 19 19 19 19 19 19 19 19 19 19 19 19 19 19 19 19 19