92 93 94 92 93 94 92 93 94 92 93 94 92 93 94 92 93 94 92 93 94 92 93 94 92 93
92 93 94 92 93 94 92 93 94 92 93 94 92 93 94 92 93 94 92 93 94 92 93 94 92 93
92 93 94 92 93 94 92 83 82 82 82 82 82 82 82 82 82 82 81 93 94 92 93 94 92 93
92 93 94 92 93 94 92 89 87 87 87 87 87 87 87 87 87 87 88 93 94 92 93 94 92 93
92 93 94 92 93 94 92 89 87 87 87 87 87 87 87 87 87 87 88 93 94 92 93 94 92 93
92 93 94 92 93 94 92 89 87 87 87 87 87 87 87 87 87 87 88 93 94 92 93 94 92 93
92 93 94 92 93 94 92 89 87 87 87 87 87 87 87 87 87 87 88 93 94 92 93 94 92 93
92 93 94 92 93 94 92 89 87 87 87 87 87 87 87 87 87 87 88 93 94 92 93 94 92 93
92 93 94 92 93 94 92 89 87 87 87 87 87 87 87 87 87 87 88 93 94 92 93 94 92 93
92 93 94 92 93 94 92 89 87 87 87 87 87 87 87 87 87 87 88 93 94 92 93 94 92 93
92 93 94 92 93 94 92 89 87 87 87 87 87 87 87 87 87 87 88 93 94 92 93 94 92 93
92 93 94 92 93 94 92 89 87 87 87 87 87 87 87 87 87 87 88 93 94 92 93 94 92 93
92 93 94 92 93 94 92 89 87 87 87 87 87 87 87 87 87 87 88 93 94 92 93 94 92 93
92 93 94 92 93 94 92 86 85 85 85 85 85 85 85 85 85 85 84 93 94 92 93 94 92 93
92 93 94 92 93 94 92 93 94 92 93 94 92 93 94 92 93 94 92 93 94 92 93 94 92 93
92 93 94 92 93 94 92 93 94 92 93 94 92 93 94 92 93 94 92 93 94 92 93 94 92 93
92 93 94 92 93 94 92 93 94 92 93 94 92 93 94 92 93 94 92 93 94 92 93 94 92 93
92 93 94 92 93 94 92 93 94 92 93 94 92 93 94 92 93 94 92 93 94 92 93 94 92 93